北京 位于 哪里	中国
首尔 位于 哪里	韩国
平壤 位于 哪里	朝鲜
东京 位于 哪里	日本
吉隆坡 位于 哪里	马来西亚
新德里 位于 哪里	印度
伊斯兰堡 位于 哪里	巴基斯坦
曼谷 位于 哪里	泰国
河内 位于 哪里	越南
科伦坡 位于 哪里	斯里兰卡
内比都 位于 哪里	缅甸
达卡 位于 哪里	孟加拉国
廷布 位于 哪里	不丹
喀布尔 位于 哪里	阿富汗
金边 位于 哪里	柬埔寨
加德满都 位于 哪里	尼泊尔
万象 位于 哪里	老挝
耶路撒冷 位于 哪里	以色列
萨那 位于 哪里	也门
马尼拉 位于 哪里	菲律宾
新加坡 位于 哪里	新加坡
马累 位于 哪里	马尔代夫
